100
#####################
#B*******$*******s**# 
#**#############   ## 
#***h*****$*********#
#**s*****## h  ###**# 
#******&*#*s**t**#**#
#**h*****# G*****#**#
#**#*****#   $***#$*#
#**#G**s*#*******#**#
#G*#*%***####D####**#
#**#*************#**#
#**#####****$***a#h*#
#**#***#*******t*#**#
#**##D############**#
#**$****%**********&#
#####################