75
#############################
#*&***$****t**#*****$*****&*#
#***###*******#*******###***#   
#*G*#*********$*********#***#
#**$***s***G******G***s*****#
#***#*********a*********#***#
#*s*###*******#*******###***#
#******t******#**$***h*****B#
#############################