45
###################
#a  *   # * *  G  #
#    *  D  * * h $#
#  % *t #  * * *  #
#  G *  # t*****  #      
#B   *  #####D#####              
#*********s*******#  
#******$*****%****#
###################